   ▄████████ ███▄▄▄▄      ▄████████  ▄█          ▄████████    ▄████████  ▄████████    ▄████████    ▄███████▄    ▄████████         ▄████████  ▄██████▄   ▄██████▄    ▄▄▄▄███▄▄▄▄   
  ███    ███ ███▀▀▀██▄   ███    ███ ███         ███    ███   ███    ███ ███    ███   ███    ███   ███    ███   ███    ███        ███    ███ ███    ███ ███    ███ ▄██▀▀▀███▀▀▀██▄ 
  ███    ███ ███   ███   ███    █▀  ███▌        ███    █▀    ███    █▀  ███    █▀    ███    ███   ███    ███   ███    █▀         ███    ███ ███    ███ ███    ███ ███   ███   ███ 
  ███    ███ ███   ███   ███        ███▌       ▄███▄▄▄       ███        ███          ███    ███   ███    ███  ▄███▄▄▄           ▄███▄▄▄▄██▀ ███    ███ ███    ███ ███   ███   ███ 
▀███████████ ███   ███ ▀███████████ ███▌      ▀▀███▀▀▀     ▀███████████ ███        ▀███████████ ▀█████████▀  ▀▀███▀▀▀          ▀▀███▀▀▀▀▀   ███    ███ ███    ███ ███   ███   ███ 
  ███    ███ ███   ███          ███ ███         ███    █▄           ███ ███    █▄    ███    ███   ███          ███    █▄       ▀███████████ ███    ███ ███    ███ ███   ███   ███ 
  ███    ███ ███   ███    ▄█    ███ ███         ███    ███    ▄█    ███ ███    ███   ███    ███   ███          ███    ███        ███    ███ ███    ███ ███    ███ ███   ███   ███ 
  ███    █▀   ▀█   █▀   ▄████████▀  █▀          ██████████  ▄████████▀  ████████▀    ███    █▀   ▄████▀        ██████████        ███    ███  ▀██████▀   ▀██████▀   ▀█   ███   █▀  
                                                                                                                                 ███    ███                                       
